000000000
000000000
001111100
000000100
000000100
000000100
000000100
000000100
000000000