111111111
100000001
101111101
101000101
1010S0001
101000101
101111101
100000001
111111111