11111111111111
100000000000011111111
1000E0001110010000001111111111111111
101111000010000000000000000000000001
101  1000010010000001001111111111101
1S11110000000111111110011111111  101
1111111011111100000000000000001  101
      101    10000100100000011111101
      101111110000111000000000000001
      100000000000000000111000111111
      1111111100010010000000001
             111111111111111111