0000000000
0000011100
0000000100
0000000100
0000000000